10 16
################
#              #
#       ########
#####      #   #
#   ##     #   #
#              #
#              #
#              #
#              #
################
