20 15
#------#-----------#                    
#......-...........#
#..................#
#..................#
#......#------#..#--
--....--      #..#  
  ....     #---..--#
           #.......#
          .-.......#
          .........#
          .---------
                    
                    
                    
                    
