16 16
#==+=#========x#
#^^^^=         #
#^^^^^         #
###+##         #
#^^^^#         #
#^^^^=         #
#^^^^^         #
#==+=#         #
#^^^^=         #
#^^^^^         #
#=+==#         #
#^^^^=         #
#^^^^^         #
#^^^^#         #
#^^^^#         #
================
