#########
# #  ####
#       #
#####   #
#   ##  #
#      ##
#########
